0,0,0,0,0,0,0
0,0,0,0,0,0,0
0,A,B,C,D,E,0
0,0,0,0,0,0,0
0,0,0,0,0,0,0
0,0,0,0,0,0,0
-1,-1,-1,-1,-1,-1,-1
0,0,0,0,0,0,0
0,0,0,0,F,0,0
0,A,B,C,D,E,0
0,0,0,0,0,0,0
0,0,0,0,0,0,0
0,0,0,0,0,0,0
-1,-1,-1,-1,-1,-1,-1
0,0,0,0,0,0,0
0,0,0,0,0,0,0
0,A,B,C,D,E,0
0,0,G,0,0,0,0
0,0,H,0,0,0,0
0,0,0,0,0,0,0
