0,0,0,0,0,0,0,0
0,A,B,C,D,E,F,0
0,0,0,0,0,0,0,0
0,0,0,0,0,G,0,0
0,A,B,C,D,E,F,0
0,0,0,0,0,0,0,0
0,A,B,C,D,0,0,0
0,0,0,0,H,0,0,0
0,0,0,0,I,0,0,0
0,0,0,0,0,0,0,0