0,0,0,0,0,0,0,0,0,0,0,0,0
0,C,0,0,0,0,0,0,0,0,0,0,0
0,B,0,0,0,0,0,0,0,0,0,0,0
0,A,D,E,F,G,H,I,J,K,L,M,0
0,0,0,0,0,0,0,0,0,0,0,0,0
0,0,0,0,0,0,Q,0,0,0,0,0,0
0,0,0,0,0,0,P,0,0,0,0,0,0
0,C,0,0,0,0,O,0,0,0,0,0,0
0,B,0,0,0,0,N,0,0,0,0,0,0
0,A,D,E,F,G,H,I,J,K,L,M,0
0,0,0,0,0,0,0,0,0,0,0,0,0
0,0,0,0,0,0,Q,0,0,0,0,0,0
0,0,0,0,0,0,P,0,0,0,0,0,0
0,C,0,0,0,R,O,0,0,0,0,0,0
0,B,0,0,0,0,N,0,0,0,0,0,0
0,A,D,E,F,G,H,I,J,K,L,M,0
0,0,0,0,0,0,0,0,0,0,0,0,0