0,0,0,0,0,0,0
0,A,B,C,D,E,0
0,0,0,F,0,G,0
0,0,0,H,0,I,0
0,0,0,0,0,0,0
